516
324
324
32400000000000000000000000000000000000000000000000yy0
32400000000000000000000000000000000000000000000005116
32400000000000000000000000000000000000000000000003224
32400000000000000000000000000000000000000000000003224
32400000000000000005160000000000000000051600000003224
32400000000000000000000000000000000000000000000003224
32400000000000000000000000000000000000000000000003224
32bf00000000000000000000000000000000000000000000ea224
322bd111111f00000000000000000000000000000000005ca2224
32222222222bd1111111111111111111111111111111ca2222224
32222222222222222222222222222222222222222222222222224
32222222222222222222222222222222222222222222222222224
32222222222222222222222222222222222222222222222222224
32222222222222222222222222222222222222222222222222224
giiiiiiiiiiiiiiii
000000000000
0000000000000
0000000000