788889
0
0
000000000000000000000788889
0
0
000000000000000000000000000000000000000000788889000000000000000000000000000000000000000000000000000007888889
0
0
00000000000000000000000000000000000000000000000000000000000000000051111111111116000000000000000000000000000000000000000000000005116
000000000000000000000000000000000000000000000000000000000000000000322222222222240000000000000000000000000000000000000000000051ca224
0000000000000000000000000000000000000000000000000000000000000000003222222222222bf00000000000516000000000000000000000000000003222224
00000000000000000000000000000000000000000000000000000000000000000032222222222222bd111111111ca24000000000000000000000000000003222224
00000000000000000000000000000000000000000000000000000000000000000032222222222222222222222222224000000000000000000000000000003222224
0000000000000000000000000000000000000000000000000000000000000000003222222222222222222222222222400000000000000000000000000000giiiiih
000000000000000000000000000000000000000000000000000000000000000000giiiiiiiiiiiiiiiiiiiiiiiiiiih000000000000000000000000000000000000000000000000000
00000000000000000000000000000000000000000000000000000000000000000000000000000000000000000000000000000000000000000000000000000000000000000000000000005160000000000000000000000000000000000000516
00000000000000000000000000000000000000000000000000000000000000000000000000000000000000000000000000000000000000000000000000000000000000000000000000003240000000000000000000000000000000000000324
00000000000000000000000000000000000000000000000000000000000000000000000000000000000000000000000000000000000000000000000000000000000000000000000000003240000000000000000000000000000000000000324
00000000000000000000000000000000000000000000000000000000000000000000000000000000000000000000000000000000000000000000000000000000000000000000000000003240000000000000000000000000000000000000324
00000000000000000000000000000000000000000000000000000000000000000000000000000000000000000000000000000000000000000000000000000000000000000000000000003240000000000000000000000000000000000003224
00000000000000000000000000000000000000000000000000000000000000000000000000000000000000000000000000000000000000000000000000000000000000000000000000003240000000000000000000000000000000000003224
00000000000000000000000000000000000000000000000000000000000000000000000000000000000000000000000000000000000000000000000000000000000000000000000000003240000000000000000000000000000000000003224
00000000000000000000000000000000000000000000000000000000000000000000000000000000000000000000000000000000000000000000000000000000000000000000000000003240000000000000000000000000000000000003224
00000000000000000000000000000000000000000000000000000000000000000000000000000000000000000000000000000000000000000000000000000000000000000000000000003240000000000000000000000000000000000003224
00000000000000000000000000000000000000000000000000000000000000000000000000000000000000000000000000000000000000000000000000000000000000000000000000003240000000000000000000000000000000000003224
000000000000000000000000000000000000000000000000000000000000000000000000000000000000000000000000000000000000000000000000000000000000000000000000000032bf000000000000000000000000000000000003224
0000000000000000000000000000000000000000000000000000000000000000000000000000000000000000000000000000000000000000000000000000000000000000000000000000322bd111111f0000000000000000000000000003224
000000000000000000000000000000000000000000000000000000000000000000000000000000000000000000000000000000000000000000000000000000000000000000000000000032222222222bd111111111111111111111111111111
00000000000000000000000000000000000000000000000000000000000000000000000000000000000000000000000000000000000000000000000000000000000000000000000000003222222222222222222222222222222222222222222
00000000000000000000000000000000000000000000000000000000000000000000000000000000000000000000000000000000000000000000000000000000000000000000000000003222222222222222222222222222222222222222222
00000000000000000000000000000000000000000000000000000000000000000000000000000000000000000000000000000000000000000000000000000000000000000000000000003222222222222222222222222222222222222222222
00000000000000000000000000000000000000000000000000000000000000000000000000000000000000000000000000000000000000000000000000000000000000000000000000003222222222222222222222222222222222222222222
00000000000000000000000000000000000000000000000000000000000000000000000000000000000000000000000000000000000000000000000000000000000000000000000000000000000giiiiiiiiiiiiiiii
00000000000000000000000000000000000000000000000000000000000000000000000000000000000000000000000000000000000000000000000000000000000000000000000000000000000000000000000
000000000000000000000000000000000000000000000000000000000000000000000000000000000000000000000000000000000000000000000000000000000000000000000000000000000000000000000000
000000000000000000000000000000000000000000000000000000000000000000000000000000000000000000000000000000000000000000000000000000000000000000000000000000000000000000000




